ama=but
anne=mother
at=horse
baba=father
bahçesi=garden
bakkal=grocery
balık=fish
bana=me
bana=me
banyo=bathroom
batı=west
ben=i
bir=1
bira=beer
bugün=today
bunlar=these
burası=here
bu=this
büyük=big
cami=mosque
cevabi=answer
çok=very
çorba=soup
deniz=sea
dere=times
domates=tomatoes
eski=old
et=meat
evet=yes
ev=home
fil=elephant
genç=old
genç=young
gün=day
hangisi=which
hastane=hospital
havalimanı=airport
havuz=pool
hayvanat bahçesi=zoo
içmek=drink
kaç=how many
kadar=much
kadın=woman
kahvaltı=breakfast
kahve=coffee
kale=castle
kilise=church
kız=girl
kolay=easy
köpek=dog
küçük=small
kumsalda=beach
küs
kuzey=north
limanda=port
limon=lemon
lütfen=please
meyve=fruit
mutfak=kitchen
müze=museum
nereden=where from?
ne=what
oda=bedroom
oğrenci=student
oğren=learn
okul=school
orada=there
ördek=duck
otel=hotel
pastane=bakery
portakal=orange
postane=post office
sabah=morning
Sağ ol=thanks
sağ=right
salt=tuz
sandviç=sandwhich
şarap=wine
sayılar=numbers
şeker=sugar
sipariş=order
sol=left
soru=question
şunlar=those
Süpermarket
şu=that
su=water
tane=quantify
tuval=toilet
tuz=salt
yağ=oil
yengeç=crab
yeterli=enough
yurmata=egg
zaman=time
zeytin=olive
zeytin yağı= olive oil
